********************
**####**************
************####****
********************
**####**************
********************
********************
********************
********************
********************
********************
********************
#####*********#*****
****#*********#*****
****#*********#*****
****#***************
****#***************
********************
*******####********
********************