********************
****####************
********************
***##***************
*****#**************
******#*************
********************
********************
********************
********************
#####***************
****#***************
****#***************
****#****##*********
****#****##*********
********************
******##************
******##************
********************
********************
